  #####
###   #
#.&B  #
### B.#
#######