############
##   #     #
##   # ..  #
##BBB #..###
# B    &####
#   #   ####
############

