############
##   #     #
##   # .   #
##BBB #..###
#      &####
#   #   ####
############