############
##   #     #
##   # .   #
##BB  #. ###
#      &####
#   #   ####
############